
{
    "oral" :
    {
        "4" : 4,
        "5" : 5,
        "6" : 6,
        "7" : 7,
        "8" : 8,
        "9" : 9
    },
    "oral-hc" :
    {
        "4" : 4,
        "5" : 5,
        "6" : 6,
        "7" : 7,
        "8" : 8,
        "9" : 9
    },
    "vaginal" :
    {
        "4" : 4,
        "5" : 5,
        "6" : 6,
        "7" : 7,
        "8" : 8,
        "9" : 9
    },
    "vaginal-hc" :
    {
        "4" : 4,
        "5" : 5,
        "6" : 6,
        "7" : 7,
        "8" : 8,
        "9" : 9
    },
    "anal" :
    {
        "4" : 4,
        "5" : 5,
        "6" : 6,
        "7" : 7,
        "8" : 8,
        "9" : 9
    },
    "anal-hc" :
    {
        "4" : 4,
        "5" : 5,
        "6" : 6,
        "7" : 7,
        "8" : 8,
        "9" : 9
    }
}
